00000011100000000000111111111
00000000000000000000000000000
00000000000000000000000000000
00000000000000000000000000000
00000000000000000000000000000
00000000000000000000000001100
00000000000000000000000110000
00000000000000000000110000000
00000000000000111100000000000
00000000000001000000000000000
00000000000111111100000000000
11111111111111111111111110000
11111111111111111111111110000