00000011100000000000
00000000000000000000
00000000000000000000
00000000000000000000
00000000000000000000
00000000000000000000
00000000000000000000
00000000000000000000
00000111100000000000
00001000000000000000
00111111100000000000
11111111111111110000
11111111111111110000